0 0 0 0 0 0 0 0 0 0 0 0 0 0 0 0 0 0 0 0 0 0 0 0 0 0 0 0 0 0 0 0 0 0 0 0 0 0 0 0 0 0 0 0 0 0 0 0 0 0 0 0 0 0 0 0 0 0 0 0 0 0 0 0 0 0 0 0 0 0 0 0 0 0 0 0 0 0 0 0 
0 0 0 0 0 0 0 0 0 0 0 0 0 0 0 0 0 0 0 0 0 0 0 0 0 0 0 0 0 0 0 0 0 0 0 0 0 0 0 0 1768 1768 1768 1768 1768 1768 1768 0 0 0 0 0 0 0 0 0 0 0 0 0 0 0 0 0 0 0 0 0 0 0 0 0 0 0 0 0 0 0 0 0 
0 0 0 0 0 0 0 0 0 0 0 0 0 0 0 0 0 0 0 0 0 0 0 0 0 0 0 0 0 0 0 0 0 0 0 0 1768 1768 1768 1768 1768 1768 2102 1768 1768 1768 1768 1768 1768 1768 1768 1768 0 0 0 0 0 0 0 0 0 0 0 0 0 0 0 0 0 0 0 0 0 0 0 0 0 0 0 0 
0 0 0 0 0 1768 1768 1768 1768 1768 1768 1768 1768 1768 1768 0 0 0 0 0 0 0 0 0 0 0 0 0 0 0 0 0 0 0 0 0 1768 1768 1768 1858 1858 1858 1858 1858 1858 1858 1858 1858 1858 1768 1768 1768 1768 1768 1768 1768 1768 1768 0 0 0 0 0 0 0 0 0 0 0 0 0 0 0 0 0 0 0 0 0 0 
0 0 0 0 0 1768 1768 2102 1768 1768 1768 1768 1768 1768 1768 1768 1768 0 0 0 0 0 0 0 0 0 0 0 0 0 0 0 0 0 1768 1768 1768 1858 1858 1858 1768 1768 1768 1768 1768 1768 1768 1858 1858 1858 1768 1768 1768 1768 1768 1768 1768 1768 1768 1768 1768 0 0 0 0 0 0 0 0 0 0 0 0 0 0 0 0 0 0 0 
0 0 0 0 1768 1768 1768 1858 1858 1858 1858 1858 1768 2103 1768 1768 1768 1768 1768 0 0 0 0 0 0 0 0 0 0 0 0 0 1768 1768 1768 1768 1858 1858 1768 1768 1768 2103 1768 1768 1768 1768 1768 1768 1768 1858 1858 1768 2102 1768 1768 1768 1768 1768 1768 1768 1768 1768 1768 1768 1768 1768 0 0 0 0 0 0 0 0 0 0 0 0 0 0 
0 0 0 1768 2102 1768 1768 1858 1858 1858 1858 1858 1858 1858 1858 1768 1768 1768 2102 1768 1768 0 0 0 0 0 0 0 0 1768 1768 1768 2103 1768 1858 1858 1858 1768 1768 1768 0 0 0 0 0 1768 1768 1768 1768 1768 1858 1858 1768 1768 1768 1768 2103 1768 2101 1768 1768 1768 1768 1768 1768 1768 1768 1768 0 0 0 0 0 0 0 0 0 0 0 0 
0 0 0 1768 1768 1768 1858 1858 1858 2105 1858 1858 1858 1858 1858 1858 1768 1768 1768 1768 1768 1768 1768 1768 1768 1768 1768 1768 1768 1768 1768 1768 1768 1858 1858 1768 1768 1768 1768 0 0 0 0 0 0 1768 1768 2101 1768 1768 1768 1858 1768 1768 2103 1768 1768 1768 1768 2102 1768 1768 1768 1768 1768 1768 2102 1768 1768 1768 1768 1768 0 0 0 0 0 0 0 0 
0 0 0 1768 1768 1768 1858 1858 1858 1858 1858 1858 1858 1858 1858 1858 1858 1768 1768 1768 1768 1768 1768 1768 1768 1768 1768 1768 1768 1768 1768 1858 1858 1768 1768 1768 1768 1768 0 0 0 0 0 0 1768 1768 1768 1768 1768 1768 1768 1858 1858 1768 2103 1768 1768 1768 1768 1768 1768 1768 2103 1768 1768 1768 1768 1768 1768 1768 1768 1768 1768 0 0 0 0 0 0 0 
0 0 1768 1768 1768 1768 1858 1858 1858 1858 1858 1858 1858 1858 1858 1858 1858 1768 1768 2103 1768 1768 2102 1768 1768 1768 1768 2102 1768 1768 1858 1858 1768 1768 1768 1768 0 0 0 0 0 0 1768 1768 1768 1768 1768 1768 1768 1768 1768 1768 1858 1768 1768 1768 1768 1768 1768 1768 1768 1768 1768 1768 1768 1768 1768 1768 1768 1768 1768 1768 1768 0 0 0 0 0 0 0 
0 0 1768 1768 2101 1768 1768 1858 1858 1858 1858 1858 1858 1858 2106 1858 1858 1768 1768 1768 1768 1768 1768 1768 1768 1768 1768 1768 1768 1858 1858 1768 1768 1768 0 0 0 0 0 0 0 1768 1768 1768 1768 1858 1858 1858 1858 1768 1768 1768 1858 1858 1858 1858 1858 1768 1768 1768 1768 1768 1768 1768 1768 1768 1768 1768 1768 1768 1768 1768 1768 1768 0 0 0 0 0 0 
0 0 1768 1768 2102 1768 1768 1858 1858 1858 1858 2104 1858 1858 1858 1858 1858 1858 1768 1768 1768 1768 1768 1768 2101 1768 1768 1768 1768 1858 1768 1768 1768 0 0 0 0 0 0 0 1768 1768 1768 2103 1768 1858 1858 1858 1858 1858 1768 1768 1858 1858 1858 1858 1858 1858 1858 1858 1858 1858 1858 1858 1768 1768 1768 1768 1768 2103 1768 1768 1768 1768 0 0 0 0 0 0 
0 0 1768 1768 1768 1768 1768 1768 1858 1858 1858 1858 1858 1858 1858 1858 1858 1858 1768 1768 1768 1768 1768 1768 1768 1768 1768 1768 1858 1768 1768 1768 0 0 0 0 0 0 0 1768 1768 1768 1768 1768 1858 1858 1858 1858 1858 1858 1768 1768 1858 1858 1858 2106 1858 1858 1858 1768 1768 1768 1768 1768 1858 1858 1858 1768 1768 1768 1768 1768 1768 1768 1768 0 0 0 0 0 
0 0 1768 1768 1768 1768 1768 1768 1768 1768 1768 1768 1858 1858 1858 1858 1858 1858 1858 1768 1768 1768 2102 1768 1768 1768 1768 1858 1858 1768 1768 0 0 0 0 0 0 0 0 1768 1768 1768 1768 1768 1858 1858 2104 1858 1858 1858 1858 1858 1858 1858 1858 1858 1858 1858 1858 1768 1768 2102 1768 1768 1768 1768 1768 1858 1858 1768 1768 1768 1768 1768 1768 0 0 0 0 0 
0 0 0 0 1768 1768 1768 1768 1768 1768 1768 1768 1768 1768 1768 1768 1768 1858 1858 1858 1768 1768 1768 1768 1768 1768 1858 1858 1768 1768 1768 0 0 0 0 0 0 0 0 1768 1768 2102 1768 1768 1858 1858 1858 1858 1858 1858 1858 1858 1858 1858 1858 1858 1858 1858 1858 1768 1768 1768 1768 1768 1768 1768 1768 1768 1768 1858 1858 1768 1768 2102 1768 1768 0 0 0 0 
0 0 0 0 0 1768 1768 1768 2102 1768 1768 1768 1768 1768 1768 1768 1768 1768 1858 1858 1858 1768 1768 1768 1768 1858 1858 1768 1768 1768 1768 0 0 0 0 0 0 0 0 1768 1768 1768 1768 1768 1858 1858 1858 1858 1858 1858 1858 1858 1858 1858 1858 1858 1858 1858 1858 1768 1768 1768 1768 1768 0 1768 1768 1768 1768 1768 1858 1768 1768 1768 1768 1768 0 0 0 0 
0 0 0 0 0 0 1768 1768 1768 1768 1768 1768 1768 2102 1768 1768 1768 1768 1768 1858 1858 1858 1858 1768 1858 1858 1768 1768 2102 1768 1768 1768 0 0 0 0 0 0 0 1768 1768 1768 1768 1768 1858 1858 1858 1858 1858 1858 1858 1858 1858 1858 1858 2105 1858 1858 1858 1768 1768 1768 1768 0 0 0 1768 1768 1768 1768 1768 1858 1768 1768 1768 1768 0 0 0 0 
0 0 0 0 0 0 0 1768 1768 1768 1768 1768 2102 1768 1768 1768 1768 1768 2102 1768 1768 1858 1858 1858 1858 1768 1768 1768 1768 1768 1768 1768 0 0 0 0 0 0 0 1768 1768 1768 1768 1768 1768 1858 1858 1858 1858 1858 1858 1858 1858 1858 1858 1858 1858 1858 1858 1768 1768 1768 1768 0 0 0 0 0 1768 1768 1768 1858 1768 1768 1768 1768 0 0 0 0 
0 0 0 0 0 0 0 1768 1768 1768 1768 1768 1768 1768 1768 1768 1768 1768 1768 1768 1768 1768 1858 1858 1768 1768 1768 1768 1768 1768 1768 1768 0 0 0 0 0 0 1768 1768 1768 2102 2103 1768 1768 1858 1858 1858 1858 1858 1858 1858 1858 1858 1858 1858 1858 1858 1768 1768 1768 1768 1768 0 0 0 0 0 1768 2103 1768 1858 1858 1768 1768 1768 1768 0 0 0 
0 0 0 0 0 0 0 0 1768 2103 1768 1768 1768 1768 1768 1768 1768 1768 1768 1768 1768 1768 1768 1858 1768 1768 1768 1768 1768 1768 1768 0 0 0 0 0 0 0 1768 1768 1768 1768 1768 1768 1768 1768 1858 1858 1858 1858 1858 1858 2105 1858 1858 1858 1858 1768 1768 1768 1768 1768 0 0 0 0 0 0 1768 1768 1768 1768 1858 1768 1768 1768 1768 0 0 0 
0 0 0 0 0 0 0 0 1768 1768 1768 1768 2103 1768 2101 1768 1768 1768 2103 1768 1768 1768 1768 1858 1768 1768 1768 1768 0 0 0 0 0 0 0 0 0 0 1768 1768 1768 1768 1768 1768 1768 1768 1768 1768 1858 1858 1858 1858 1858 1858 1858 1858 1768 1768 1768 2102 1768 1768 0 0 0 0 0 1768 1768 1768 1768 1768 1858 1768 1768 1768 1768 0 0 0 
0 0 0 0 0 0 0 0 1768 1768 1768 1768 1768 1768 1768 1768 1768 1768 1768 1768 1768 1768 1858 1858 1768 1768 1768 0 0 0 0 0 0 0 0 0 0 0 1768 1768 1768 1768 2101 1768 1768 1768 1768 1768 1768 1768 1858 1858 1858 1858 1858 1858 1768 1768 1768 1768 1768 1768 0 0 0 0 0 1768 1768 2102 1768 1768 1858 1768 2102 1768 1768 1768 0 0 
0 0 0 0 0 0 0 0 0 1768 1768 1768 1768 1768 1768 1768 1768 1768 1768 1768 1768 1858 1858 1768 1768 1768 0 0 0 0 0 0 0 0 0 0 0 0 1768 1768 1768 1768 1768 1768 1768 1768 1768 1768 1768 1768 1768 1858 1858 1858 1858 1768 1768 1768 1768 1768 1768 0 0 0 0 0 0 1768 1768 1768 1768 1768 1858 1768 1768 1768 1768 1768 0 0 
0 0 0 0 0 0 0 0 0 1768 1768 1768 2102 1768 1768 1768 1768 1768 1768 1768 1768 2106 1858 1768 1768 0 0 0 0 0 0 0 0 0 0 0 0 1768 1768 1768 1768 1768 1768 1768 1768 1768 1768 1768 1768 1768 1768 1768 1858 1858 1768 1768 1768 1768 1768 1768 0 0 0 0 0 0 1768 1768 1768 2101 1768 1768 1858 1768 1768 1768 1768 1768 0 0 
0 0 0 0 0 0 0 0 0 1768 1768 1768 1768 1768 1768 1768 1768 1768 1768 1768 1858 1858 1858 1768 1768 0 0 0 0 0 0 0 0 0 0 0 1768 1768 1768 1768 2102 1768 1768 1768 1768 1768 2102 1768 1768 2103 1768 1768 1858 1858 1768 1768 2102 1768 1768 1768 0 0 0 0 0 0 1768 1768 1768 2102 1768 1768 1858 1768 1768 1768 1768 1768 0 0 
0 0 0 0 0 0 0 0 0 1768 1768 1768 1768 1768 1768 1768 1768 1858 1858 1858 1858 1768 1858 1768 1768 0 0 0 0 0 0 0 0 0 0 1768 1768 1768 1768 1768 1768 1768 1768 1768 1768 1768 1768 1768 1768 1768 1768 1768 1858 1858 1768 1768 1768 1768 1768 0 0 0 0 0 0 0 1768 1768 1768 1768 1768 1768 1858 1768 1768 1768 1768 1768 0 0 
0 0 0 0 0 0 0 0 0 1768 2102 1768 1768 1768 1768 1768 1858 1858 1768 1768 1768 1768 1858 1768 1768 0 0 0 0 0 0 0 0 1768 1768 1768 1768 1768 1768 1768 1768 1768 1768 1768 1768 1768 1768 1768 1768 1768 1768 1768 1768 1858 1768 1768 1768 1768 1768 0 0 0 0 0 0 0 0 1768 1768 1768 2103 1768 1858 1768 1768 2102 1768 1768 1768 0 
0 0 0 0 0 0 0 0 0 1768 1768 1768 1768 1768 1768 1858 1858 1768 1768 1768 1768 1768 1858 1858 1768 1768 0 0 0 0 1768 1768 1768 1768 1768 1768 1768 1768 1768 1768 1768 1768 1768 1768 1768 2103 1768 1768 1768 1768 1768 1768 1768 1858 1768 1768 1768 1768 0 0 0 0 0 0 0 0 0 1768 1768 1768 1768 1768 1858 1768 1768 1768 1768 1768 1768 0 
0 0 0 0 0 0 0 0 1768 1768 1768 1768 1768 1768 1858 1858 1768 1768 1768 1768 1768 1768 1858 1858 1768 1768 1768 1768 1768 1768 1768 1768 1768 1768 2102 1768 1768 1768 1768 1768 2103 1768 1768 1768 1768 1768 1768 1768 2103 1768 1768 1768 1768 1858 1768 1768 1768 0 0 0 0 0 0 0 0 0 0 0 1768 1768 1768 1768 1858 1768 1768 1768 1768 1768 1768 0 
0 0 0 0 0 0 0 0 1768 1768 1768 1768 1768 1768 1858 1768 1768 2103 2102 1768 1768 1768 1858 1768 1768 1768 1768 1768 1768 1768 1768 1768 1768 1768 1768 1768 1768 1768 1768 1768 1768 1768 1768 1768 1768 1768 1768 1768 1768 1768 1768 1768 1858 1768 1768 1768 1768 0 0 0 0 0 0 0 0 0 0 0 1768 1768 1768 1768 1858 1768 1768 2103 1768 1768 1768 0 
0 0 0 0 0 0 0 1768 1768 1768 1768 1768 1858 1858 1768 1768 1768 1768 1768 1768 1768 1768 1858 1768 1768 1768 1768 1768 1768 1768 1768 1768 1768 1768 1768 1768 1768 2103 2101 1768 1768 1768 2102 1768 1768 1768 1768 1768 1768 1768 1768 1768 1858 1768 1768 1768 0 0 0 0 0 0 0 0 0 0 0 0 1768 2102 1768 1768 1858 1768 1768 1768 1768 1768 1768 0 
0 0 0 0 0 0 0 1768 1768 1768 1768 1768 1858 1768 1768 2102 1768 1768 1768 1768 1768 1858 1858 1768 1768 1768 1768 1768 2102 1768 1768 1768 1768 1768 1768 1768 1768 1768 1768 1768 1768 1768 1768 1768 2102 1768 1768 1768 1768 1768 1768 1858 1768 1768 1768 0 0 0 0 0 0 0 0 0 0 0 0 0 1768 1768 1768 1768 1858 1768 1768 1768 1768 1768 1768 0 
0 0 0 0 0 0 1768 1768 1768 1768 1768 1858 1858 1768 1768 1768 1768 1768 1768 1768 1768 1858 1768 1768 1768 1768 1768 1768 1768 2103 1768 2103 1768 1768 1768 1768 1768 1768 1768 1768 1768 1768 1768 1768 1768 1768 1768 1768 1768 1768 1858 1858 1768 1768 0 0 0 0 0 0 0 0 0 0 0 0 0 1768 1768 1768 1768 1768 1858 1768 1768 1768 2101 1768 1768 0 
0 0 0 0 0 0 1768 1768 1768 1768 1768 1858 1768 1768 1768 1768 2101 1768 2102 1768 1858 1858 1768 1768 1768 1768 1768 1768 1768 1768 1768 1768 2103 1768 1768 1768 1768 1768 1768 1768 1768 1768 1768 1768 1768 1768 1768 1768 1768 1858 1858 1768 1768 1768 0 0 0 0 0 0 0 0 0 0 0 0 0 1768 1768 1768 1768 1768 1858 1768 2102 1768 1768 1768 1768 0 
0 0 0 0 0 1768 1768 2102 1768 1768 1858 1858 1768 1768 2103 1768 1768 1768 2102 1768 1858 1768 1768 1768 1768 1768 1768 1768 1768 1768 1768 1768 1768 1768 1768 1768 1768 1768 1768 1768 1768 1768 1768 1768 1768 1768 1768 1768 1858 1858 1768 1768 1768 1768 0 0 0 0 0 0 0 0 0 0 1768 1768 1768 1768 1768 1768 1768 1858 1858 1768 1768 1768 1768 1768 1768 0 
0 0 0 0 1768 1768 1768 1768 1768 1768 1858 1768 1768 1768 1768 1768 1768 1768 1768 1768 1858 1768 1768 1768 2103 1768 1768 1768 1768 1768 1768 1768 1768 1768 1768 1768 1768 2102 1768 2103 1768 1768 2102 1768 1768 1768 1768 1858 1858 1768 1768 1768 1768 0 0 0 0 0 0 0 0 0 0 1768 1768 1768 1768 1768 1768 1768 1768 1858 1768 1768 1768 1768 1768 1768 1768 0 
0 0 0 0 1768 1768 1768 1768 1768 1858 1858 1768 1768 1768 2102 1768 1768 1768 1768 1768 1858 1768 1768 1768 1768 1768 1768 1768 2102 2103 1768 1768 1768 1768 1768 1768 1768 1768 1768 1768 1768 1768 1768 1768 1768 1768 1858 1858 1768 1768 1768 2102 1768 1768 0 0 0 0 0 0 1768 1768 1768 1768 1768 1768 1768 2102 1768 1768 1768 1858 1768 1768 1768 1768 1768 1768 1768 0 
0 0 0 1768 1768 1768 1768 1768 1768 1858 1768 1768 1768 1768 1768 1768 1768 1768 1768 1768 1858 1768 1768 1768 1768 1768 1768 1768 1768 2101 1768 2103 1768 1768 1768 2102 1768 1768 1768 1768 2102 1768 1768 1768 1768 1768 1858 1768 1768 1768 1768 1768 1768 1768 1768 1768 0 0 1768 1768 1768 1768 2102 1768 1768 1768 1768 1768 1768 1768 1858 1858 1768 1768 1768 2103 1768 1768 1768 0 
0 0 0 1768 1768 1768 1768 1768 1768 1858 1768 1768 1768 1768 1768 1768 1768 1768 1768 1768 1858 1768 1768 1768 1768 2102 1768 1768 1768 1768 1768 1768 1768 1768 1768 1768 1768 1768 1768 1768 1768 1768 1768 1768 1858 1858 1768 1768 1768 1768 1768 1768 1768 1768 1768 1768 1768 1768 1768 1768 1768 1768 1768 1768 1768 2102 1768 1768 1768 1768 1858 1768 1768 1768 1768 1768 1768 1768 1768 0 
0 0 1768 1768 1768 2102 2102 1768 1768 1858 1768 1768 1768 1768 1768 1768 1768 1768 1768 1768 1858 1768 1768 1768 1768 1768 1768 1768 1768 1768 1768 1768 1768 1768 1768 1768 1768 1768 1768 1768 1768 1768 1768 1858 1858 1768 2102 1768 1768 2102 1768 1768 1768 1768 1768 2102 1768 1768 1768 1768 1768 2103 1768 1768 1768 1768 1768 1768 1858 1858 1858 1858 1858 1768 2102 1768 1768 1768 1768 0 
0 0 1768 1768 1768 1768 1768 1768 1768 1858 1768 1768 2101 1768 1768 1768 1768 2102 1768 1768 1858 1768 1768 1768 1768 1768 1768 1768 1768 1768 1768 1768 1768 1768 1768 1768 1768 1768 1768 1768 1768 1768 1858 1858 1768 1768 1768 1768 1768 1768 1768 1768 1768 1768 1768 1768 1768 1768 1768 1768 1768 1768 1768 1768 1768 1768 1768 1768 1858 1858 1858 1858 1858 1768 1768 1768 1768 1768 1768 0 
0 0 1768 1768 1768 1768 1768 1768 1768 1858 1768 1768 1768 1768 0 1768 1768 1768 1768 1768 1858 1858 1768 1768 1768 1768 1768 1768 1768 1768 1768 1768 1768 1768 1768 1768 1768 1768 1768 1768 1768 1858 1858 1768 1768 1768 1768 1768 1768 1768 1768 2101 1768 1768 1768 1768 1768 1768 1768 1768 1858 1858 1858 1858 1858 1858 1858 1858 1858 2106 1858 1858 1858 1858 1768 1768 1768 1768 1768 0 
0 0 1768 1768 1768 1768 1768 1768 1858 1858 1768 1768 1768 1768 0 0 0 1768 1768 1768 1768 1858 1768 1768 1768 1768 1768 2102 1768 1768 1768 1768 1768 1768 2101 1768 1768 1768 1768 1768 1858 1858 1768 1768 1768 1768 2102 1768 1768 1768 1768 1768 1768 1768 1768 1768 1768 1768 1858 1858 1768 1768 1768 1768 1768 1768 1768 1858 1858 1858 1858 1858 1858 1858 1768 1768 1768 1768 1768 0 
0 0 1768 1768 2101 1768 2102 1768 1858 1768 1768 1768 1768 1768 0 0 0 0 0 1768 1768 1768 1858 1768 1768 1768 1768 1768 2102 1768 1768 1768 1768 1768 1768 1768 1768 1768 1768 1768 1858 1768 1768 1768 1768 1768 1768 1768 1768 1768 1768 1768 1768 1768 1768 1858 1858 1858 1768 1768 1768 2102 2102 1768 2103 1768 1768 1858 1858 1858 1858 2104 1858 1858 1768 1768 1768 1768 1768 0 
0 0 1768 1768 1768 1768 1768 1768 1858 1768 1768 1768 1768 1768 0 0 0 0 0 1768 1768 1768 1858 1858 1768 1768 1768 1768 1768 1768 1768 1768 1768 1768 1768 1768 1768 1768 1768 1858 1858 1768 1768 1768 1768 1768 1768 1768 1768 1768 1768 1768 1858 1858 1858 1768 1768 1768 1768 1768 1768 1768 1768 1768 1768 1768 1768 1858 1858 1858 1858 1858 1858 1768 1768 1768 2102 1768 1768 0 
0 0 1768 1768 1768 1768 1768 1768 1858 1768 2102 2102 1768 0 0 0 0 0 0 0 1768 1768 1768 1858 1858 1768 1768 1768 1768 1768 1768 1768 1768 1768 1768 1768 1858 1858 1858 1858 1858 1858 1858 1858 1768 1768 1768 1768 1768 1768 1768 1858 1768 1768 1768 1768 1768 1768 1768 1768 1768 1768 1768 1768 1768 1768 1768 1858 1858 1768 1768 1768 1768 1768 1768 1768 1768 1768 1768 0 
0 0 1768 1768 1768 1768 1768 1768 1858 1768 1768 1768 1768 0 0 0 0 0 0 0 1768 2103 1768 1768 1858 1858 1858 1858 1858 1858 1858 1858 1858 1858 1858 1858 1858 1858 1858 1858 1858 1858 1858 1858 1768 1768 1768 1768 1768 1858 1858 1768 1768 1768 1768 1768 0 0 0 0 1768 1768 2102 1768 1768 1768 1858 1858 1768 1768 1768 1768 1768 1768 1768 1768 1768 1768 0 0 
0 0 1768 1768 2102 1768 1768 1768 1858 1768 1768 1768 1768 0 0 0 0 0 0 0 1768 1768 1768 1768 1768 1768 1768 1858 1858 1858 1858 1858 1858 1858 1858 1858 1858 1858 1858 1858 1858 1858 1858 1858 1858 1858 1858 1858 1858 1768 1768 2102 1768 1768 1768 0 0 0 0 0 0 1768 1768 1768 2103 1768 1858 1768 1768 1768 1768 1768 1768 1768 1768 1768 1768 1768 0 0 
0 0 1768 1768 1768 1768 1768 1768 1858 1768 1768 1768 0 0 0 0 0 0 0 0 1768 1768 2102 1768 1768 1768 1858 1858 1858 1858 1858 1858 1858 1858 1858 1858 1858 1858 1858 1858 1858 1858 1858 1858 1858 1858 1768 1768 1768 1768 1768 1768 1768 1768 0 0 0 0 0 0 0 1768 1768 1768 1768 1858 1768 1768 1768 1768 1768 1768 1768 2102 1768 1768 1768 1768 0 0 
0 0 1768 1768 1768 1768 1768 1768 1858 1768 1768 1768 0 0 0 0 0 0 0 0 1768 1768 1768 1768 1768 1858 1858 1858 1858 1858 1858 1858 1858 1858 1858 1858 1858 1858 1858 1858 1858 1858 1858 1858 1858 1858 1768 1768 1768 1768 1768 1768 1768 0 0 0 0 0 0 0 0 1768 1768 1768 1858 1858 1768 1768 1768 1768 1768 1768 1768 1768 1768 1768 1768 1768 0 0 
0 0 1768 1768 1768 2102 1768 1768 1858 1768 1768 1768 0 0 0 0 0 0 0 0 0 2103 1768 1768 1768 1858 1858 1858 1858 1858 1858 2106 1858 1858 1858 1858 1858 2106 1858 1858 1858 1858 1858 1858 2104 1858 1858 1768 1768 1768 1768 1768 1768 0 0 0 0 0 0 0 1768 1768 1768 1768 1858 1768 1768 1768 1768 2102 1768 1768 1768 1768 1768 1768 1768 1768 0 0 
0 0 1768 1768 2103 1768 1768 1768 1858 1768 1768 1768 0 0 0 0 0 0 0 0 0 1768 2103 1768 1768 1858 1858 1858 1858 1858 1858 1858 1858 1858 1858 1858 1858 1858 1858 1858 1858 1858 1858 1858 1858 1858 1858 1768 1768 1768 1768 1768 0 0 0 0 0 0 0 0 1768 1768 1768 1768 1858 1768 1768 1768 1768 1768 1768 1768 1768 1768 1768 1768 1768 1768 0 0 
0 0 1768 1768 1768 2102 1768 1768 1858 1858 1768 1768 0 0 0 0 0 0 0 0 0 1768 1768 1768 1768 1858 1858 1858 1858 1858 1858 1858 1858 1858 1858 1858 1858 1858 1858 1858 1858 1858 1858 1858 1858 1858 1858 1768 2102 1768 1768 0 0 0 0 0 0 0 0 0 1768 1768 1768 1858 1858 1768 1768 1768 1768 1768 1768 1768 1768 1768 2101 1768 1768 1768 0 0 
0 0 1768 1768 1768 1768 1768 1768 1858 1858 1768 1768 0 0 0 0 0 0 0 0 0 1768 1768 1768 1768 1858 1858 2105 1858 1858 1858 1858 1858 1858 1858 1858 1858 1858 1858 1858 1858 1858 1858 1858 1858 1858 1858 1768 1768 1768 1768 0 0 0 0 0 0 0 0 1768 1768 1768 1768 1858 1768 1768 1768 1768 1768 1768 1768 1768 1768 1768 1768 1768 1768 0 0 0 
0 0 1768 1768 1768 1768 1768 1768 1768 1858 1768 1768 0 0 0 0 0 0 0 0 0 1768 2102 1768 1768 1858 1858 1858 1858 1858 1858 1858 1858 1858 1858 1858 1858 1858 1858 1858 1858 1858 1858 1858 1858 1858 1858 1768 1768 1768 0 0 0 0 0 0 0 0 1768 1768 1768 1768 1858 1768 1768 1768 1768 1768 1768 2102 1768 1768 1768 1768 1768 1768 1768 0 0 0 
0 0 1768 1768 1768 2103 1768 1768 1768 1858 1768 1768 0 0 0 0 0 0 0 0 0 1768 1768 1768 1768 1858 1858 1858 1858 1858 1858 1858 1858 1858 1858 1858 1858 1858 1858 1858 1858 1858 1858 2105 1858 1858 1858 1768 1768 1768 0 0 0 0 0 0 0 0 1768 1768 1768 2102 1858 1768 1768 1768 2102 1768 1768 1768 1768 1768 1768 1768 1768 1768 0 0 0 0 
0 0 1768 1768 1768 1768 1768 1768 1768 1858 1768 1768 0 0 0 0 0 0 0 0 0 1768 1768 1768 1768 1858 1858 1858 1858 1858 1858 1858 1858 1858 2104 1858 1858 1858 1858 2106 1858 1858 1858 1858 1858 1858 1768 1768 1768 0 0 0 0 0 0 0 0 1768 1768 1768 1768 1768 1858 1768 1768 1768 1768 1768 1768 2103 1768 1768 1768 1768 1768 1768 0 0 0 0 
0 0 2102 1768 1768 1768 1768 1768 2102 1858 1768 1768 0 0 0 0 0 0 0 0 0 1768 1768 1768 1768 1858 1858 1858 1858 1858 1858 1858 1858 1858 1858 1858 1858 1858 1858 1858 1858 1858 1858 1858 1768 1768 1768 1768 1768 0 0 0 0 0 0 0 1768 1768 1768 1768 1768 1858 1768 1768 1768 1768 1768 1768 1768 1768 1768 1768 1768 1768 2103 1768 0 0 0 0 
0 0 1768 1768 1768 1768 1768 1768 1768 1858 1768 1768 1768 0 0 0 0 0 0 0 1768 1768 1768 1768 1768 1768 1858 1858 1858 1858 1858 1858 1858 1858 1858 1858 1858 1858 1858 1858 1858 1858 1858 1858 1768 1768 1768 1768 1768 0 0 0 0 0 0 0 1768 1768 1768 1768 1768 1858 1768 1768 1768 1768 1768 1768 1768 1768 1768 1768 1768 1768 1768 1768 0 0 0 0 
0 0 1768 1768 1768 1768 1768 1768 1768 1858 1858 1768 1768 1768 0 0 0 0 0 0 1768 1768 2102 1768 1768 1768 1858 1858 1858 1858 2106 1858 1858 1858 1858 1858 1858 1858 1858 1858 1858 1858 1858 1768 1768 1768 1768 1768 1768 0 0 0 0 0 0 1768 1768 1768 1768 1768 1858 1768 1768 1768 1768 1768 1768 1768 1768 2102 1768 1768 1768 1768 1768 1768 0 0 0 0 
0 0 1768 1768 1768 1768 1768 1768 1768 1858 1858 1768 1768 1768 0 0 0 0 0 0 1768 1768 1768 1768 1768 1768 1768 1858 1858 1858 1858 1858 1858 1858 1858 1858 1858 1858 1858 1858 1858 1768 1858 1858 1768 1768 1768 2103 1768 1768 0 0 0 1768 1768 1768 1768 2103 1768 1768 1858 1768 1768 1768 1768 2101 1768 1768 1768 1768 1768 1768 1768 1768 1768 1768 0 0 0 0 
0 0 1768 1768 1768 1768 1768 1768 1768 1768 1858 1768 1768 1768 1768 0 0 0 1768 1768 1768 1768 1768 1768 1768 1768 1768 1768 1858 1858 1858 1858 1858 2105 1858 1858 1858 1858 1858 1858 1858 1768 1768 1858 1768 1768 1768 1768 1768 1768 1768 1768 1768 1768 1768 1768 1768 1768 1768 1858 1768 1768 1768 1768 1768 1768 2102 1768 1768 1768 2102 1768 1768 1768 1768 1768 0 0 0 0 
0 0 1768 2102 1768 1768 2101 1768 1768 1768 1858 1858 1768 1768 1768 1768 1768 1768 1768 1768 1768 2102 1768 1768 1768 1858 1858 1858 1858 1858 1858 1858 1858 1858 1858 1858 1858 1858 1858 1858 1768 1768 1768 1858 1768 1768 1768 1768 1768 1768 1768 1768 1768 1768 1768 1768 1768 1768 1768 1858 1768 1768 1768 1768 2102 1768 1768 1768 1768 1768 1768 1768 1768 1768 1768 0 0 0 0 0 
0 0 1768 1768 1768 1768 1768 1768 1768 1858 1858 1858 1858 1768 1768 1768 1768 1768 1768 1768 1768 1768 1768 1858 1858 1858 1768 1768 1768 1768 1858 1858 1858 1858 1858 1858 1858 1858 1768 1768 1768 1768 1768 1768 1858 1768 1768 1768 2103 1768 1768 1768 1768 1768 1768 1768 1768 1768 1858 1768 1768 1768 1768 1768 1768 1768 1768 1768 1768 1768 1768 1768 1768 1768 1768 0 0 0 0 0 
0 0 1768 1768 1768 1768 1768 1768 1768 1858 1858 1858 1858 1858 1858 1858 1858 1768 1768 1768 1768 1768 1858 1858 1768 1768 1768 1768 1768 1768 1768 1768 1858 1858 1858 1858 1768 1768 2102 1768 1768 1768 1768 1768 1858 1768 1768 1768 1768 1768 2102 1768 1768 1768 1768 1768 1768 1858 1768 1768 1768 1768 1768 1768 1768 1768 1768 1768 1768 1768 1768 1768 1768 1768 0 0 0 0 0 0 
0 0 1768 1768 1768 2102 1768 1768 1858 1858 1858 1858 1858 1858 1858 1858 1858 1858 1858 1768 1858 1858 1768 1768 1768 1768 1768 1768 1768 1768 1768 1768 1768 1768 1768 1768 1768 1768 1768 1768 1768 1768 1768 1768 1858 1768 1768 1768 1768 1768 1768 1768 1768 1768 1768 1768 1768 1858 1858 1858 1858 1858 1858 1858 1858 1858 1768 1768 1768 1768 2102 1768 1768 1768 0 0 0 0 0 0 
0 0 1768 1768 1768 1768 1768 1768 1858 1858 2104 1858 1858 1858 1858 2106 1858 1858 1858 1858 1858 1768 1768 1768 1768 2102 1768 1768 1768 1768 1768 1768 1768 1768 2102 1768 1768 1768 1768 1768 1768 1768 1768 1768 1768 1858 1768 1768 1768 1768 1768 1768 1768 1768 1768 1858 1858 1858 1858 1858 1858 1858 1858 1858 1858 1858 1858 1858 1768 1768 1768 1768 1768 1768 0 0 0 0 0 0 
0 0 1768 1768 1768 1768 1768 1768 1768 1858 1858 1858 1858 1858 1858 1858 1858 1858 1858 1858 1858 1858 1768 1768 1768 1768 1768 2103 1768 1768 1768 1768 1768 2103 1768 1768 1768 1768 2101 1768 1768 1768 1768 1768 1768 1768 1858 1768 1768 1768 1768 1768 1768 2103 1858 1858 1858 1858 1858 2105 1858 1858 1858 1858 1858 1858 1858 1858 1768 1768 1768 1768 1768 1768 0 0 0 0 0 0 
0 0 1768 1768 2102 1768 1768 1768 1768 1858 1858 1858 2105 1858 1858 1858 1858 1858 1858 1858 1858 1858 1858 1768 1768 1768 1768 2102 1768 1768 1768 1768 1768 1768 1768 1768 1768 1768 1768 1768 1768 1768 1768 1768 1768 2101 1768 1858 1768 1768 1768 1768 1768 1858 1858 1858 1858 1858 1858 1858 1858 1858 1858 1858 1858 1858 1858 1858 1858 1768 1768 1768 1768 0 0 0 0 0 0 0 
0 0 1768 1768 1768 2102 1768 1768 1768 1858 1858 1858 1858 1858 1858 1858 1858 1858 1858 1858 1858 1858 1858 1768 1768 1768 1768 1768 1768 1768 1768 2101 1768 1768 1768 1768 2102 1768 1768 1768 1768 1768 1768 1768 1768 1768 1768 1858 1768 1768 1768 1858 1858 1858 1858 1858 1858 1858 1858 1858 1858 2104 1858 1858 1858 1858 1858 1858 1858 1768 1768 1768 1768 0 0 0 0 0 0 0 
0 0 1768 1768 1768 1768 1768 1768 1768 1858 1858 1858 1858 1858 1858 1858 1858 1858 2104 1858 1858 1858 1858 1768 1768 1768 1768 1768 1768 1768 1768 1768 1768 1768 1768 1768 1768 1768 1768 1768 1768 1768 1768 1768 1768 1768 1768 1858 1858 1768 1858 1858 1858 1858 1858 1858 1858 1858 1858 1858 1858 1858 1858 1858 1858 1858 1858 1858 1858 1768 1768 1768 1768 0 0 0 0 0 0 0 
0 0 0 1768 1768 2102 1768 1768 1768 1768 1858 1858 1858 1858 1858 1858 1858 1858 1858 1858 1858 1858 1858 1768 1768 1768 1768 1768 1768 1768 1768 1768 1768 1768 1768 1768 1768 1768 1768 1768 2103 1768 2102 1768 1768 1768 1768 1768 1858 1858 1858 1858 1858 1858 1858 1858 1858 1858 1858 1858 1858 1858 1858 1858 1858 1858 1858 1858 1858 1768 1768 1768 1768 0 0 0 0 0 0 0 
0 0 0 1768 1768 1768 1768 1768 1768 1768 1858 1858 1858 1858 1858 1858 1858 1858 1858 1858 1858 1858 1858 1858 1858 1858 1858 1858 1768 1768 1768 1768 1768 1768 1768 1768 1768 1768 1768 1768 1768 2102 1768 1768 1768 1768 1768 1768 1858 1858 1858 1858 1858 1858 1858 1858 1858 1858 1858 1858 1858 1858 1858 1858 1858 1858 1858 1858 1858 1768 1768 1768 1768 0 0 0 0 0 0 0 
0 0 0 0 1768 1768 1768 1768 1768 2101 1768 1858 1858 1858 1858 1858 1858 2106 1858 1858 1858 1858 1858 1768 1768 1768 1768 1858 1858 1858 1858 1858 1858 1768 2102 1768 1768 1768 1768 1768 1768 1768 1768 1768 1768 1768 1768 1768 1768 1858 1858 1858 2106 1858 1858 1858 1858 1858 2104 1858 1858 1858 1858 1858 1858 1858 1858 1858 1768 2103 1768 1768 1768 0 0 0 0 0 0 0 
0 0 0 0 0 0 1768 1768 1768 1768 1768 1858 1858 1858 2104 1858 1858 1858 1858 1858 1858 1858 1768 1768 1768 2102 1768 1768 1768 1768 1768 1768 1858 1858 1858 1858 1858 1858 1858 1858 1858 1858 1858 1858 1858 1858 1858 1858 1858 1858 1858 1858 1858 1858 1858 1858 1858 1858 1858 1858 1858 2106 1858 1858 1858 1858 1858 1858 1768 1768 1768 1768 1768 0 0 0 0 0 0 0 
0 0 0 0 0 0 0 0 1768 1768 1768 1768 1768 1858 1858 1858 1858 1858 1858 1858 1768 1768 1768 1768 1768 1768 1768 1768 1768 1768 1768 1768 1768 1768 1768 1768 1768 1768 1768 1768 1768 1768 1768 1768 1768 1768 1768 1768 1768 1858 1858 1858 1858 1858 1858 1858 1858 1858 1858 1858 1858 1858 1858 1858 1858 1858 1858 1768 1768 1768 1768 2102 1768 0 0 0 0 0 0 0 
0 0 0 0 0 0 0 0 0 1768 1768 1768 2102 1768 1768 1768 1768 1768 1768 1768 1768 1768 1768 1768 1768 1768 2101 2102 1768 1768 1768 1768 1768 1768 2102 1768 1768 1768 1768 1768 1768 1768 1768 2102 1768 1768 1768 1768 1768 1768 1768 1768 1768 1768 1768 1858 1858 1858 1858 1858 1858 1858 1858 1768 1768 1768 1768 1768 1768 1768 1768 1768 0 0 0 0 0 0 0 0 
0 0 0 0 0 0 0 0 0 0 0 1768 1768 1768 1768 1768 1768 1768 1768 1768 1768 1768 1768 2102 1768 1768 1768 1768 1768 1768 1768 1768 1768 1768 1768 1768 1768 1768 1768 1768 1768 1768 1768 1768 0 0 0 0 0 0 0 0 0 1768 1768 1768 1768 1768 1768 1768 1768 1768 1768 1768 1768 1768 1768 1768 1768 0 0 0 0 0 0 0 0 0 0 0 
0 0 0 0 0 0 0 0 0 0 0 0 0 0 0 0 0 0 0 0 0 0 0 0 0 0 0 0 0 0 0 0 0 0 0 0 0 0 0 0 0 0 0 0 0 0 0 0 0 0 0 0 0 0 0 0 0 0 0 0 0 0 0 0 0 0 0 0 0 0 0 0 0 0 0 0 0 0 0 0 
0 0 0 0 0 0 0 0 0 0 0 0 0 0 0 0 0 0 0 0 0 0 0 0 0 0 0 0 0 0 0 0 0 0 0 0 0 0 0 0 0 0 0 0 0 0 0 0 0 0 0 0 0 0 0 0 0 0 0 0 0 0 0 0 0 0 0 0 0 0 0 0 0 0 0 0 0 0 0 0